100 -1 25 60 195 330 465 500 60 1 1 0 0 0 50 200
100 -1 25 60 195 330 465 500 60 2 2 0 0 0 50 200
100 -1 25 60 195 330 465 500 60 3 3 0 0 0 50 200
100 -1 25 60 195 330 465 500 60 4 4 0 0 0 50 200
100 -1 25 60 195 330 465 500 60 5 5 0 0 0 50 200
100 -1 25 60 195 330 465 500 60 6 8 0 0 0 50 200
200 -1 100 150 350 650 950 1250 150 7 9 0 0 0 110 450
200 -1 100 150 350 650 950 1250 150 8 10 0 0 0 110 450
200 -1 100 150 350 650 950 1250 150 9 11 0 0 0 110 450
200 -1 100 150 350 650 950 1250 150 10 13 0 0 0 110 450
200 -1 100 150 350 650 950 1250 150 11 14 0 0 0 110 450
200 -1 100 150 350 650 950 1250 150 12 16 0 0 0 110 450
400 -1 200 320 640 960 1180 1500 320 13 17 0 0 0 250 675
400 -1 200 320 640 960 1180 1500 320 14 18 0 0 0 250 675
400 -1 200 320 640 960 1180 1500 320 15 20 0 0 0 250 675
400 -1 200 320 640 960 1180 1500 320 16 21 0 0 0 250 675
400 -1 200 320 640 960 1180 1500 320 17 23 0 0 0 250 675
800 -1 350 500 867 1000 1367 2300 500 18 24 0 0 0 410 900
800 -1 350 500 867 1000 1367 2300 500 19 25 0 0 0 410 900
800 -1 350 500 867 1000 1367 2300 500 20 26 0 0 0 410 900
800 -1 350 500 867 1000 1367 2300 500 21 28 0 0 0 410 900
800 -1 350 500 867 1000 1367 2300 500 22 29 0 0 0 410 900Plage de Radhanagar
Calanques_en_Vau
Bora bora
Plage de la Teresitas
Champagne beach
La Digue
Diani beach
Camp Bay
Legzira
Navagio
Baia di san
Zanzibar
Playa del carmen
Kare kare
Long beach
Plage de Patong
Ipanema beach
Santa monica
Iles perhentian
Main beach byron bay
Kauai
Plage de l'Anse gros raisin
